F       100,10,123
NO ./texture/EST.xpm
WE ./texture/OUEST.xpm
C 42,42,42
SO ./texture/OUEST.xpm
EA ./texture/OUEST.xpm                                                              


    111111   111111
  11000001   1100001
 100000000111010011
 1111000000N000011
 111111111111111111111111111
 101
 111
 1
 1
 1
 1
 1
 1
 1
 1
 1
 1
 1
 1
 1
 1
 1
 1
 1
 1
 1
 1
 1
 1
 1
 1
 1
 1
 1
 1
 1
 1
 1
 1
 1
 1
 111
 101
 101
 101
 101
 101
 101
 101
 101
 101
 101
 101
 101
 101
 101
 101
 101
 101
 101
 101
 101
 101
 101
 101
 101
 101
 101
 101
 101
 101
 101
 101
 101
11011