NO ./texture/NORD.xpm
SO ./texture/SUD.xpm
WE ./texture/OUEST.xpm
EA ./texture/EST.xpm

F 220,100,0
C 225,30,0

11111111111111111011111111111
10000111000000000000000000001
10001111110000000100000000001
10000011000000000100011011001
10000000000000000100010000011
10011100000010000100010000011
10010100000000000000000000011
10010100000000000001111011111
100100000000000000000100000W1
11011101111111110111111111111
10000100000100000000010010001
10000100010100100001010010001
10000100010000100001000000001
11111111111111111111111111111
