F       249,130,0
NO ./texture/EST.xpm
WE ./texture/OUEST.xpm
C 42,42,42
SO ./texture/OUEST.xpm
EA ./texture/OUEST.xpm                                                              



    11          11  11 111
    111            111    1
    111            111
    111      1111111111
    11    11111111111111
11111111111111111111111
 1
1111111111111111111111111
                        1
                        1111111111111111111111111111111111111111111111
                        11111111111111111S01111111111111111111111
                        11111111111111111111111111111111111111111