1111111111
1010110001
101S110101
1110000011
1000000001
1111111111