1111111111
1010110001
1010110101
1110000011
10000N0001
1111111111