1111111111
1010000011
1010000101
100P011001
1000000001
1111111111