NO ./texture/NORD.xpm
SO ./texture/SUD.xpm
WE ./texture/OUEST.xpm
EA ./texture/EST.xpm

F 107,87,49
C 187,174,152

    111111111111  11111111111111111          
    100001110001  10000000000000001            
1111100011111101  10000100000000001            
10000011000011001110110110111111111            
100000000000000001000100000001100011                 
10011100000010000100010000011  1111              
1001111111110100000000000000011100011
1001       101000000000000011111111       
1001      100000N000001000011                              
110111111111111110111111111111                         
11110100000100000000010010001                                
    1000010001001111000101000111111111 111111             
    100001000101    100100000000000001  100001         
    111111111111    11111111111111111   111111         
