NO ./texture/NORD.xpm
SO ./texture/SUD.xpm
WE ./texture/OUEST.xpm
EA ./texture/EST.xpm

F 107,87,49
C 187,174,152

11111111111111    111111111111111
100001110000001    1100000000000001
1000111111000001   1 100100000000001
10000011000000001110111011001
10000000000000000100010000011
10011100000010000100010000011
100101000000011100000000011
1001010000001   1010000001111011111
1001000000000111000001000001
11011101111111110111111111111
10000100000100000000010010001
10000100010100100N01010010001
10000100010011100100001000000001
11111111111111111111111111111
