NO ./texture/NORD.xpm
SO ./texture/SUD.xpm
WE ./texture/OUEST.xpm
EA ./texture/EST.xpm

F 107,87,49
C 187,174,152

    111111111111  11111111111111111
    100001110001  10000000000000001
1111100011111101  10000100000000001
1000001100001100110011011011111111
100000000000000001000100000001100011
10011100000010000100010000011  111
100111111110100000000000000001100011
1001       1010000W000000001111011111
1001       100000000000010000111
11011110111111110111111111111
11110100000100000000010010001
    10000100010011110001010001111111111
    100001000101    100100000000000001
    111111111111    11111111111111111
