NO ./texture/M1.xpm
SO ./texture/M2.xpm
WE ./texture/M3.xpm
EA ./texture/M4.xpm

F  25,25,25
C 100,100,200

                   111111111111111111111
                   100000000000000000001
                   100000000000000000001
                   100000000000000000001
                   100000000000000000001
                   100000000000000000001
                   100000000000000000001
                   100000000000000000001
                   111111111000011111111
                           100001
                           100001
                           100001
              1111111111111100001111111111111
111111111     1000000000000000000000000000001     111111111
100000001     1000000000000000000000000000001     100000001
100000001     1000000000000000000000000000001     100000001
10000000111111100000000000000000000000000000111111100000001
10000000000000000000000000000000000000000000000000000000001
10000000000000000000000000000000000000000000000000000000001
10000001111111100000000000000000000000000000111111100000001
10000001      1000000000000000000000000000001     1000000N1
10000001      1000000000000000000000000000001     111111111
11111111      1000000000000000000000000000001
              1111111111111100001111111111111
                           100001
                           100001
                           100001
                   111111111000011111111
                   100000000000000000001
                   100000000000000000001
                   100000000000000000001
                   100000000000000000001
                   100000000000000000001
                   100000000000000000001
                   100000000000000000001
                   111111111111111111111