NO ./texture/W1.xpm
SO ./texture/W2.xpm
WE ./texture/W3.xpm
EA ./texture/W4.xpm

F 107,87,49
C 187,174,152

1111111111111111111111111
1S10000001111000000001001
1010100111110100000000101
1010100001000111111000011              111111111
101000000000000110000000111111111111111100000001
101010000000000000000000100010000100001000100101
100010001111110001000000001000100001000000100101
111110001000000001000000111111111111111100000001
1110000011100000010000001              111111111
1111111001111100111100111
1111100000000000000000001
1111111111111111111111111
