NO ./texture/D1.xpm
SO ./texture/D2.xpm
WE ./texture/D3.xpm
EA ./texture/D4.xpm
F 107,87,49
C 187,174,152

111111
100001
10000111
11100001
  10111
  101
111011
100N01
111011
   11