NO ./texture/f1.xpm
SO ./texture/f2.xpm
WE ./texture/f3.xpm
EA ./texture/f4.xpm

F 153,0,76
C 255,102,178

1111111111111111111111111111111111111111111111111111
1000000000000000000000000000000000000000000000000001
1011111111111111111111111111111111111111111111111101
1010000000000000000000000000000000000000000000000001
1010111111111111111111111111111111111111111111110101
1010000000000000000000000000000000000000000000010101
1010101111111111111111111111111111111111111111010101
1010101000000000000000000000000000000000000001010101
1010101010111111111111111111111111111111111101010101
1010101010000000000000000000000000000000000101010101
1010101010111111111111111111111111111111110101010101
1010101010100000000000000000000000000000010101010101
1010101010101111111111111111111111111111010101010101
1010101010101000000000000000000000000000010101010101
1010101010101011111111111111111111111101010101010101
1010101010101010000000000000000000000101010101010101
1010101010101010111111111111111111110101010101010101
1010101010101010100000000000000000010101010101010101
1010101010101010101011111111111111010101010101010101
1010101010101010101000000000000001010101010101010101
1010101010101010101011111111111101010101010101010101
1010101010101010101010000000000101010101010101010101
1010101010101010101010110111110101010101010101010101
1010101010101000101010100000010101010101010101010101
1010101010101010101010101111010101010101010101010101
1010101010101010101010101S01010101010101010101010101
1010101010101010101010101001010101010101010101010101
1010101010101010101010101011010101010101010101010101
1010101010101010101010100000010101010101010101010101
1010101010101010101010111111110101010101010101010101
1010101010101010101010000000000101010101010101010101
1010101010101010101011111111101101010101010101010101
1010101010101010101000000000000001010101010101010101
1010101010101010101111111111111111010101010101010101
1010101010101010100000000000000000000101010101010101
1010101010101010111111111111111111110101010101010101
1010101010101010000000000000000000000101010101010101
1010101010101011111111111111111111111101010101010101
1010101010101000000000000000000000000001010101010101
1010101010101111111111111111111111111111010101010101
1010101010100000000000000000000000000000010101010101
1010101010101111111111111111111111111111110101010101
1010101010000000000000000000000000000000000101010101
1010101011111111111111111111111111111111111101010101
1010101000000000000000000000000000000000000001010101
1000101111111111110111111111111111111111111111010101
1010100000000000000000000000000000000000000000010101
1010111111111111111111111111111111111111111111110101
1010000000000000000000000000000000000000000000000101
1011111111111111111111111111111111111111111111111101
1000000000000000000000000000000000000000000000000001
1111111111111111111111111111111111111111111111111111
